1111111
1C000E1
1000001
10P0001
1111111
