111111111111111
10C0000C010C0E1
100000011100001
111C000001100C1
1001110000C0001
1P0C000C0000C01
111111111111111
