1111111111
1E00000C01
1010010101
1010C01101
1P00000C01
1111111111
