11111111111
1C00000C0C1
101001C1001
1001C0100E1
1C00000C0P1
11111111111
